---#--###--#@
-#---#----##-
####-#-#-#-##
---#---#-#---
-#-####---##-
-#-----@#----
-############
-------------